NO ./sp/no.xpm
SO ./sp/so.xpm
WE ./sp/we.xpm
EA ./sp/ea.xpm


F 250,100,255
C 225,30,255

              1111
            N 1111
              1111