SO ./sp/so.xpm
WE ./sp/we.xpm
EA ./sp/ea.xpm
NO ./sp/no.xpm

F F 255,100,255
C 225,30,255

         1111111111
         11111111111
    1111110001 1000011111
    1110011110101111111111
    1101001111111000011111
    1111000000001001010111
11111000000000111111001111
1110011110000000000000001111
111111111000000011111111
100000000000N0000000000011
1000000000000011111111111
11111111111111111111111111
